0*00000000
0000000500
0000000000
0020000000
0000000000
0000000030